###########
#00000000N#
#000K00000#
#000000000#
#0000000F0#
#000000000#
#T00000000#
#000000000#
#0000S0000#
#000000000#
###########