###########
#K0000000N#
#TT0000000#
#000000000#
#0000000F0#
#000000000#
#000000000#
#FT0000000#
#T0000W000#
#N0000000N#
###########